;
##########
##########
##########
##########
#@  $   .#
##########
##########
##########
##########
##########

;
##########
##########
##########
##########
##########
##########
##########
##########
#@  $   .#
##########

;
##########
##########
##########
##########
##########
##########
##########
#        #
#.  $   @#
##########

;
##########
#        #
#        #
#        #
# . $   @#
#        #
#        #
#        #
#        #
##########
