;
#######
#######
#######
#######
## @ ##
##bAa##
#######


;
#######
#######
#######
###@###
##   ##
##bAa##
#######


;
#######
#######
#######
## @###
#bA ###
##a####
#######

