;
#######
#     #
#     #
## ####
# B ab#
#@ ####
#######

