;
#######
#######
#######
##@Aa##
#######
#######
#######


;
#######
#######
#######
##@Bb##
#######
#######
#######


;
#######
#######
#######
#@ Aa##
#######
#######
#######


;
#######
#######
#######
#@ Bb##
#######
#######
#######


;
#######
#######
#######
#@ A a#
#######
#######
#######


;
#######
#######
#######
##@Aa##
#######
#######
#######


;
#######
#######
#######
##@Aa##
#######
#######
#######


;
#######
#######
#######
##@Aa##
#######
#######
#######


;
#######
#######
#######
##@Aa##
#######
#######
#######


;
#######
#  B b#
#     #
#@ A a#
#     #
#  C c#
#######

