;
#######
#######
#######
##@Aa##
#######
#######
#######


;
#######
#######
#######
#@ Aa##
#######
#######
#######


;
#######
#######
#######
#@ A a#
#######
#######
#######


;
#######
#######
##@Aa##
#######
#######
#######
#######


;
#######
#######
#@ Aa##
#######
#######
#######
#######


;
#######
#######
#@ A a#
#######
#######
#######
#######


;
#######
##@Aa##
#######
#######
#######
#######
#######


;
#######
#@ Aa##
#######
#######
#######
#######
#######


;
#######
#@ A a#
#######
#######
#######
#######
#######


;
#######
#######
#######
##@Aa##
### ###
#######
#######


;
#######
#######
#######
#@ Aa##
##  ###
#######
#######


;
#######
##   ##
#######
#@ A a#
#######
#######
#######


;
#######
#######
##@Aa##
##   ##
#######
#######
#######


;
#######
#######
#@ Aa##
#   ###
#######
#######
#######


;
#######
##### #
#@ A a#
#     #
#######
#######
#######


;
#######
## Aa##
##@####
#######
#######
#######
#######


;
#######
#######
#######
##@Aa##
###B###
###b###
#######


;
#######
#######
#######
#@ Aa##
###B###
###b###
#######


;
#######
#######
#######
#@ A a#
####B##
####b##
#######


;
#######
#######
##@Aa##
##B####
##b####
#######
#######


;
#######
#######
#@ A a#
###   #
## ####
#######
#######


;
#######
##@Aa##
### ###
###B###
###b###
#######
#######


;
#######
#  Aa##
# @####
#######
#######
#######
#######


;
#######
#######
##@Aa##
## Bb##
#######
#######
#######


;
#######
#######
#@ Aa##
#  Bb##
#######
#######
#######


;
#######
##### #
#@ A a#
#   Bb#
#######
#######
#######


;
#######
#######
## Bb##
##@Aa##
## Cc##
#######
#######


;
#######
###b###
###B###
#@ Aa##
###C###
###c###
#######


;
#######
####b##
####B##
#@ A a#
####C##
####c##
#######


;
#######
#######
##@Aa##
### ###
### Bb#
#######
#######


;
#######
#######
#  Aa##
# #####
#@#####
#######
#######


;
#######
#######
###  a#
### A##
####@##
#######
#######


;
#######
## Aa##
##@####
##B####
##b####
#######
#######


;
#######
#@ Aa##
##  a##
##B####
##b####
#######
#######


;
#######
#  Aa##
# @Bb##
###Cc##
#######
#######
#######


;
#######
## Aa##
## ####
##@B b#
#######
#######
#######

